level2
/........../
/........../
/.1......../
/____...___/
/BBBB...BBB/
/.......1../
/__....__../
/........../
/........../
/BBB......H/
/___.2...__/
