level4
/..B.2...B./
/...___..../
/........B./
/.......___/
/...H...BBB/
/...B...1../
/..._____../
/.1..B..B../
/__......../
/B..2....1./
/B__B....__/
