level1
/........../
/....._____/
/......BBBB/
/........../
/BBBBBBBBBB/
/..1...1.../
/________../
/........../
/........../
/BBB......1/
/___..H..__/
