level3
/........../
/..___..BB./
/..BBB....1/
/.......___/
/.H.....BBB/
/.......1../
/__....__../
/........../
/.BBBBBBB../
/..___....1/
/..2.....__/
