level5
/........../
/........H./
/........../
/........../
/........../
/........../
/........../
/........../
/........../
/..P......./
/........../
